You have been left in some strange cell.

DS
An Interactive Fiction by Cameron
Release 1 / Serial number 250127 / Inform 7 v10.1.2 / D

Undead Asylum
You find yourself in a dimly lit cell, damp and cold. The air is thick with the smell of moss and decay.

The door to the cell, rusted and ancient, as if no soul has touched it in centuries.

You can also see a rock here.

>ask
What do you want to ask yourself for?

>rock
You can't see any such thing.

>unlock door
What do you want to unlock the cell door with?

>rock
(first taking the rock)
You use the rock on the cell door. It breaks the rusty lock open with a loud clank. The door slowly creaks open.

>go through door
(first opening the cell door)

Asylum Corridor
You step into a narrow, dimly lit hallway, the air thick with the scent of mildew and decay. The cold, damp stone walls seem to close in around you, their surfaces slick with moisture. Flickering torches cast long, dancing shadows that seem to twist and writhe like malevolent spirits.

The door to the cell, rusted and ancient, as if no soul has touched it in centuries.

A small, flickering bonfire sits here, offering a brief respite from the darkness. The flames seem to whisper secrets long forgotten.

You can also see a Corridor Door here.

>go through corridor door
(first opening the Corridor Door)
As you step into the Asylum Grounds, the heavy door slams shut behind you with a resounding thud. The sound reverberates through the air, and you hear the click of a lock. There is no going back.

The air grows heavier, and you hear the deep, guttural growl of the Asylum Demon echoing through the walls. You must hurry.

>go through corridor door
Asylum Corridor
You step into a narrow, dimly lit hallway, the air thick with the scent of mildew and decay. The cold, damp stone walls seem to close in around you, their surfaces slick with moisture. Flickering torches cast long, dancing shadows that seem to twist and writhe like malevolent spirits.

The door to the cell, rusted and ancient, as if no soul has touched it in centuries.

A small, flickering bonfire sits here, offering a brief respite from the darkness. The flames seem to whisper secrets long forgotten.

You can also see a Corridor Door here.

>go through corridor door
Asylum Grounds
The grounds stretch out before you, illuminated only by flickering torches. Shadows dance menacingly along the walls. There is a sense of foreboding that makes your skin crawl.

You can see a Corridor Door, a Hallway Door and an Asylum Demon here.

You hear the thunderous steps of the Asylum Demon drawing closer. You feel its presence looming over you. Time is running out.

>go through door
Which do you mean, the Corridor Door or the Hallway Door?

>hallway
(first opening the Hallway Door)

Lower Asylum Hallway
A gloomy hallway stretches into the shadows, the flickering light barely revealing the cold stone walls.

An old iron door, its surface mottled with rust.

A towering figure in battered armor stands here, leaning heavily on a massive sword. The helmet obscures their face, but their posture suggests exhaustion rather than hostility.

You can also see a Hallway Door here.

>ask person
You can't see any such thing.

>look
Lower Asylum Hallway
A gloomy hallway stretches into the shadows, the flickering light barely revealing the cold stone walls.

An old iron door, its surface mottled with rust.

A towering figure in battered armor stands here, leaning heavily on a massive sword. The helmet obscures their face, but their posture suggests exhaustion rather than hostility.

You can also see a Hallway Door here.

>examine person
You can't see any such thing.

>examine figure
You can't see any such thing.

>ask armored knight
What do you want to ask the Armored Knight for?

>a weapon
The knight tilts their head slightly, as if trying to comprehend your words. "I do not understand your request," they say finally.
The knight tilts their head slightly, as if trying to comprehend your words. "I do not understand your request," they say finally.
The knight tilts their head slightly, as if trying to comprehend your words. "I do not understand your request," they say finally.
The knight tilts their head slightly, as if trying to comprehend your words. "I do not understand your request," they say finally.

* * *

You have been left in some strange cell.

DS
An Interactive Fiction by Cameron
Release 1 / Serial number 250127 / Inform 7 v10.1.2 / D

Undead Asylum
You find yourself in a dimly lit cell, damp and cold. The air is thick with the smell of moss and decay.

The door to the cell, rusted and ancient, as if no soul has touched it in centuries.

You can also see a rock here.

>go east
closet
Yikes, everything in here is cleaning supplies. Shelves and shelves of them.

>open closet
You can't see any such thing.

>open cabinet
You can't see any such thing.

* * *

You have been left in some strange cell.

DS
An Interactive Fiction by Cameron
Release 1 / Serial number 250127 / Inform 7 v10.1.2 / D

Undead Asylum
You find yourself in a dimly lit cell, damp and cold. The air is thick with the smell of moss and decay.

The door to the cell, rusted and ancient, as if no soul has touched it in centuries.

You can also see a rock here.

>go to cell door
You can't see any such thing.

>open cell door
You can't see any such thing.

>enter cell door
You can't see any such thing.

* * *

You have been left in some strange cell.

DS
An Interactive Fiction by Cameron
Release 1 / Serial number 250127 / Inform 7 v10.1.2 / D

Undead Asylum
You find yourself in a dimly lit cell, damp and cold. The air is thick with the smell of moss and decay.

The door to the cell, rusted and ancient, as if no soul has touched it in centuries.

You can also see a rock here.

>look at cell
Full of moss and water.

On the cell floor is a small rock.

>pick up small rock
Taken.

* * *

You have been left in some strange cell.

DS
An Interactive Fiction by Cameron
Release 1 / Serial number 250127 / Inform 7 v10.1.2 / D

Undead Asylum
You find yourself in a dimly lit cell, damp and cold. The air is thick with the smell of moss and decay.

The door to the cell, rusted and ancient, as if no soul has touched it in centuries.

You can also see a rock here.

>look at floor
Full of moss and water.

On the cell floor is a small rock.

>pick up rock
Taken.

>use rock
That's not a verb I recognise.

>throw rock
Dropped.

>pick up rock
Taken.

>go to cell door
You can't see any such thing.

>go cell door
You can't see any such thing.

>look at cell
Full of moss and water.

* * *

You have been left in some strange cell.

DS
An Interactive Fiction by Cameron
Release 1 / Serial number 250127 / Inform 7 v10.1.2 / D

Undead Asylum
You find yourself in a dimly lit cell, damp and cold. The air is thick with the smell of moss and decay.

The door to the cell, rusted and ancient, as if no soul has touched it in centuries.

You can also see a rock here.

>look at ground
Filled with moss, water, and a few small rocks.

On the ground of the cell is a small rock.

>look ground
You can't see any such thing.

* * *

>look at ground
Filled with moss, water, and a few small rocks.

On the ground of the cell is a small rock.

>pick up rock
Taken.

>open up door
I only understood you as far as wanting to open up.

>open door
It's locked, and you don't have the key.

>use rock
That's not a verb I recognise.

* * *

>throw rock
Dropped.

>look at ground
Filled with moss, water, and a few small rocks.

>pick up rock
Taken.

* * *

You have been left in some strange cell.

DS
An Interactive Fiction by Cameron
Release 1 / Serial number 250127 / Inform 7 v10.1.2 / D

Undead Asylum
You find yourself in a dimly lit cell, damp and cold. The air is thick with the smell of moss and decay.

The door to the cell, rusted and ancient, as if no soul has touched it in centuries.

You can also see a rock here.

>open door
It seems to be locked.

>unluck door
That's not a verb I recognise.

>unlock cell
What do you want to unlock the cell door with?

>sword
You use the broken sword to pry at the lock. After some effort, the rusty lock gives way, and the door slowly creaks open.

>go through door
(first opening the cell door)

Asylum Corridor
You step into a narrow, dimly lit hallway, the air thick with the scent of mildew and decay. The cold, damp stone walls seem to close in around you, their surfaces slick with moisture. Flickering torches cast long, dancing shadows that seem to twist and writhe like malevolent spirits.

A sturdy door looms to keep things in. Or out.

The door to the cell, rusted and ancient, as if no soul has touched it in centuries.

A small, flickering bonfire sits here, offering a brief respite from the darkness. The flames seem to whisper secrets long forgotten.

>go through door
Which do you mean, the Corridor Door or the cell door?

>corridor
(first opening the Corridor Door)

Asylum Grounds
The grounds stretch out before you, illuminated only by flickering torches. Shadows dance menacingly along the walls. There is a sense of foreboding that makes your skin crawl.

A sturdy door looms to keep things in. Or out.

A heavy wooden door creaks ominously on its hinges.

You can also see an Asylum Demon here.

>go through door
Which do you mean, the Corridor Door or the Hallway Door?

>hallway
(first opening the Hallway Door)

Lower Asylum Hallway
A gloomy hallway stretches into the shadows, the flickering light barely revealing the cold stone walls.

A heavy wooden door creaks ominously on its hinges.

An old iron door, its surface mottled with rust.

>go through door
Which do you mean, the Hallway Door or the Upper Hallway Door?

>upper
(first opening the Upper Hallway Door)

Upper Asylum Hallway
A chilling silence pervades the air in this narrow, dark hallway. The faint sound of dripping water echoes through the space.

An old iron door, its surface mottled with rust.

A frail figure slumps against the wall, their armor battered and bloodstained. They clutch a deep wound in their side, struggling to breathe. The seem to be holding a strange vial very tightly.

>greet soldier
The soldier's head tilts slightly, their eyes fluttering open. They look at you weakly, a faint glimmer of recognition in their gaze.

>ask soldier what is the vial
"This vial," the soldier whispers, holding it weakly. "It will sustain you for a time... but use it wisely. Such gifts are rare."

>inventory
You are carrying:
  a health vial
  a tattered map
  a broken sword

* * *

You have been left in some strange cell.

DS
An Interactive Fiction by Cameron
Release 1 / Serial number 250127 / Inform 7 v10.1.2 / D

Undead Asylum
You find yourself in a dimly lit cell, damp and cold. The air is thick with the smell of moss and decay.

The door to the cell, rusted and ancient, as if no soul has touched it in centuries.

You can also see a rock here.

>open hallway door
It's locked tight.

* * *

You have been left in some strange cell.

DS
An Interactive Fiction by Cameron
Release 1 / Serial number 250127 / Inform 7 v10.1.2 / D

Undead Asylum
You find yourself in a dimly lit cell, damp and cold. The air is thick with the smell of moss and decay.

The door to the cell, rusted and ancient, as if no soul has touched it in centuries.

You can also see a rock here.

>pick up rock
Taken.

* * *

>go to cell door
You can't see any such thing.

>go to cell
You can't see any such thing.

>go cell
You can't see any such thing.

* * *

>pick up rock
Taken.

>look aroudn
You can't see any such thing.

>look around
You can't see any such thing.

>look
Undead Asylum
You find yourself in a dimly lit cell, damp and cold. The air is thick with the smell of decay. Heavy chains rattle against the stone walls. A distant sound of groaning echoes through the corridors.

The door is shut, however rusted and ancient, as if no soul has touched it in centuries.

>open the door
It seems to be locked.

>take inventory
You are carrying:
  a rock
  a tattered map
  a broken sword

>examine broken sword
An ancient sword, its blade chipped and rusted. It feels heavy in your hand.

>use sword on door
That's not a verb I recognise.

>use the broken sword on the cell door
That's not a verb I recognise.

>unlock the door
What do you want to unlock the cell door with?

>sword
You use the broken sword to pry at the lock. After some effort, the rusty lock gives way, and the door slowly creaks open.

>open the door
You open the cell door.

>close the door
You close the cell door.

>open the door
You open the cell door.

>go through the cell door
Asylum Corridor
The corridor stretches out before you, illuminated only by flickering torches. Shadows dance menacingly along the walls. There is a sense of foreboding that makes your skin crawl.

The door is shut, however rusted and ancient, as if no soul has touched it in centuries.

A small, flickering bonfire sits here, offering a brief respite from the darkness. The flames seem to whisper secrets long forgotten.

A massive, grotesque demon, its body twisted and malformed. It wields a giant hammer, ready to crush any who dare challenge it.

>swing sword at the demon
I only understood you as far as wanting to swing the broken sword.

>swing sword at the aslyum demon
I only understood you as far as wanting to swing the broken sword.

>swing sword at the asylum demon
I only understood you as far as wanting to swing the broken sword.

>take aslyum demon
You can't see any such thing.

>attack asylum demon
You swing your broken sword at the demon, but it barely scratches its hide. The demon roars in anger.

>attack asylum demon
You swing your broken sword at the demon, but it barely scratches its hide. The demon roars in anger.

* * *

>pick up rock
Taken.

>throw at cell door
You can't see any such thing.

>look at cell door
You can't see any such thing.

>look at cell
Filled with moss and water.

* * *

You have been left in some strange cell.

DS
An Interactive Fiction by Cameron
Release 1 / Serial number 250127 / Inform 7 v10.1.2 / D

Undead Asylum
You find yourself in a dimly lit cell, damp and cold. The air is thick with the smell of moss and decay.

The door to the cell, rusted and ancient, as if no soul has touched it in centuries.

You can also see a rock here.

>scream and cry
That's not a verb I recognise.

>take rock
Taken.

>unlock cell door
What do you want to unlock the cell door with?

>rock
You use the rock on the cell door. It breaks the rusty lock open with a loud clank. The door slowly creaks open.

>go through the door
(first opening the cell door)

Asylum Corridor
You step into a narrow, dimly lit hallway, the air thick with the scent of mildew and decay. The cold, damp stone walls seem to close in around you, their surfaces slick with moisture. Flickering torches cast long, dancing shadows that seem to twist and writhe like malevolent spirits.

The door to the cell, rusted and ancient, as if no soul has touched it in centuries.

A small, flickering bonfire sits here, offering a brief respite from the darkness. The flames seem to whisper secrets long forgotten.

You can also see a Corridor Door here.

>go through corridor door
(first opening the Corridor Door)

Asylum Grounds
The grounds stretch out before you, illuminated only by flickering torches. Shadows dance menacingly along the walls. There is a sense of foreboding that makes your skin crawl.

You can see a Corridor Door, a Hallway Door and an Asylum Demon here.

The air grows heavier, and you hear the deep, guttural growl of the Asylum Demon echoing through the walls. You must hurry.

>attack demon
You throw the miniscule rock at the demon. The rock crumbles into dust after colliding with its hide. Now what?

You hear the thunderous steps of the Asylum Demon drawing closer. You feel its presence looming over you. Time is running out.

>go through hallway door
(first opening the Hallway Door)

Lower Asylum Hallway
A gloomy hallway stretches into the shadows, the flickering light barely revealing the cold stone walls.

An old iron door, its surface mottled with rust.

A towering figure in battered armor stands here, leaning heavily on a massive sword. The helmet obscures their face, but their posture suggests exhaustion rather than hostility.

You can also see a Hallway Door here.

>talk to figure
That's not a verb I recognise.

>ask figure for sword
(the Armored Knight first taking the broken sword)
The Armored Knight has better things to do.

>ask figure about sword
"A weapon of great strength," the knight says, handing you a massive greatsword. "Wield it with care."

>inventory
You are carrying:
  a greatsword
  a tattered map
  a broken sword

>go through hallway door
Which do you mean, the Hallway Door or the Upper Hallway Door?

>hallway
Which do you mean, the Hallway Door or the Upper Hallway Door?

>hallway door
Which do you mean, the Hallway Door or the Upper Hallway Door?

>go west
Asylum Grounds
The grounds stretch out before you, illuminated only by flickering torches. Shadows dance menacingly along the walls. There is a sense of foreboding that makes your skin crawl.

You can see a Hallway Door, a Corridor Door and an Asylum Demon here.

>attack demon
You swing your broken sword at the demon, but it barely scratches its hide. The demon roars in anger. Maybe you should find another way to survive.

>go through hallway
Lower Asylum Hallway
A gloomy hallway stretches into the shadows, the flickering light barely revealing the cold stone walls.

An old iron door, its surface mottled with rust.

A towering figure in battered armor stands here, leaning heavily on a massive sword. The helmet obscures their face, but their posture suggests exhaustion rather than hostility.

You can also see a Hallway Door here.

>go through door
Which do you mean, the Hallway Door or the Upper Hallway Door?

>upper halway
You can't see any such thing.

>upper
That's not a verb I recognise.

>go through upper
(first opening the Upper Hallway Door)

Upper Asylum Hallway
A chilling silence pervades the air in this narrow, dark hallway. The faint sound of dripping water echoes through the space.

An old iron door, its surface mottled with rust.

A frail figure slumps against the wall, their armor battered and bloodstained. They clutch a deep wound in their side, struggling to breathe. The seem to be holding a strange vial very tightly.

>take vial
That seems to belong to the Dying Soldier.

>ask dying soldier for the vial
The Dying Soldier has better things to do.

>greet soldier
The soldier's head tilts slightly, their eyes fluttering open. They look at you weakly, a faint glimmer of recognition in their gaze.

>ask dying soldier about vial
The soldier coughs weakly, struggling to comprehend your question. "I... I don't know..." they whisper before slumping further.

>ask dying soldier what is vial
"This vial," the soldier whispers, holding it weakly. "It will sustain you for a time... but use it wisely. Such gifts are rare."

He lessens his grip on the health vial and hands you it shakily.

>inventory
You are carrying:
  a health vial
  a greatsword
  a tattered map
  a broken sword

>ask dying soldier who is the demon
"The demon... it was not always like this," the soldier whispers, voice frail. "It was created... a protector turned monster by dark magic."

>ask soldier why the vial
"Why give this to you?" The soldier exhales weakly. "Because your survival is our only hope. Take it... and live."

He lessens his grip on the health vial and hands you it shakily.

>ask soldier what is the bonfire
"The bonfire," the soldier whispers. "It connects this place to... something ancient. A refuge... but also a beacon. Use it well."

>go through hallway door
Lower Asylum Hallway
A gloomy hallway stretches into the shadows, the flickering light barely revealing the cold stone walls.

An old iron door, its surface mottled with rust.

A towering figure in battered armor stands here, leaning heavily on a massive sword. The helmet obscures their face, but their posture suggests exhaustion rather than hostility.

You can also see a Hallway Door here.

>go the hallway door
Which do you mean, the Upper Hallway Door or the Hallway Door?

>west
I only understood you as far as wanting to go west.

>west
Asylum Grounds
The grounds stretch out before you, illuminated only by flickering torches. Shadows dance menacingly along the walls. There is a sense of foreboding that makes your skin crawl.

You can see a Hallway Door, a Corridor Door and an Asylum Demon here.

>attack demon
You swing your broken sword at the demon, but it barely scratches its hide. The demon roars in anger. Maybe you should find another way to survive.

>attack demon
You swing your broken sword at the demon, but it barely scratches its hide. The demon roars in anger. Maybe you should find another way to survive.

* * *

You have been left in some strange cell.

DS
An Interactive Fiction by Cameron
Release 1 / Serial number 250127 / Inform 7 v10.1.2 / D

Undead Asylum
You find yourself in a dimly lit cell, damp and cold. The air is thick with the smell of moss and decay.

The door to the cell, rusted and ancient, as if no soul has touched it in centuries.

You can also see a rock here.

>showme
Undead Asylum - room
    cell door - locked door
    yourself - person
        tattered map
        broken sword
    rock

>look
Undead Asylum
You find yourself in a dimly lit cell, damp and cold. The air is thick with the smell of moss and decay.

The door to the cell, rusted and ancient, as if no soul has touched it in centuries.

You can also see a rock here.

* * *

You have been left in some strange cell.

DS
An Interactive Fiction by Cameron
Release 1 / Serial number 250127 / Inform 7 v10.1.2 / D

Undead Asylum
You find yourself in a dimly lit cell, damp and cold. The air is thick with the smell of moss and decay.

The door to the cell, rusted and ancient, as if no soul has touched it in centuries.

You can also see a rock here.

>take rock
Taken.

>open door
It seems to be locked.

>unlock door with rock
You use the rock on the cell door. It breaks the rusty lock open with a loud clank. The door slowly creaks open.

>go through door
(first opening the cell door)

Asylum Corridor
You step into a narrow, dimly lit hallway, the air thick with the scent of mildew and decay. The cold, damp stone walls seem to close in around you, their surfaces slick with moisture. Flickering torches cast long, dancing shadows that seem to twist and writhe like malevolent spirits.

A sturdy door to keep things in. Or out.

The door to the south is shut, however rusted and ancient, as if no soul has touched it in centuries.

A small, flickering bonfire sits here, offering a brief respite from the darkness. The flames seem to whisper secrets long forgotten.

>sit at bonfire
I didn't understand that sentence.

>sit bonfire
I didn't understand that sentence.

>sit down
I didn't understand that sentence.

>open door
Which do you mean, the Corridor Door or the cell door?

>corridor door
You open the Corridor Door.

>go through
What do you want to go through?

>the corridor door
Asylum Grounds
The corridor stretches out before you, illuminated only by flickering torches. Shadows dance menacingly along the walls. There is a sense of foreboding that makes your skin crawl.

A sturdy door to keep things in. Or out.

You can also see an Asylum Demon here.

>look at asylum demon
A massive, grotesque demon, its body twisted and malformed. It wields a giant hammer, ready to crush any who dare challenge it.

>attack demon
You throw the miniscule rock at the demon. The rock crumbles into dust after colliding with its hide. Now what?

>attack demon
You swing your broken sword at the demon, but it barely scratches its hide. The demon roars in anger.

>attack dmeon
You can't see any such thing.

>attack demon
You swing your broken sword at the demon, but it barely scratches its hide. The demon roars in anger.

* * *

>open door
It seems to be locked.

>use rock on door
That's not a verb I recognise.

>unlock door with rock
You use the rock on the cell door. It breaks the rusty lock open with a loud clank. The door slowly creaks open.

>go through door
(first opening the cell door)

Asylum Corridor
A huge door looms ahead.

A sturdy door to keep things in. Or out.

The door to the south is shut, however rusted and ancient, as if no soul has touched it in centuries.

A small, flickering bonfire sits here, offering a brief respite from the darkness. The flames seem to whisper secrets long forgotten.

* * *

You have been left in some strange cell.

DS
An Interactive Fiction by Cameron
Release 1 / Serial number 250127 / Inform 7 v10.1.2 / D

Undead Asylum
You find yourself in a dimly lit cell, damp and cold. The air is thick with the smell of moss and decay.

The door to the cell, rusted and ancient, as if no soul has touched it in centuries.

You can also see a rock here.

>unlock cell
What do you want to unlock the cell door with?

>go through
What do you want to go through?

>unlock cell
What do you want to unlock the cell door with?

>rock
(first taking the rock)
You use the rock on the cell door. It breaks the rusty lock open with a loud clank. The door slowly creaks open.

>south
As you step into the corridor, you feel a chill run down your spine. The bonfire's light flickers, casting eerie shadows. In the distance, you hear the sound of heavy footsteps.

(first opening the cell door)

Asylum Corridor
You step into a narrow, dimly lit hallway, the air thick with the scent of mildew and decay. The cold, damp stone walls seem to close in around you, their surfaces slick with moisture. Flickering torches cast long, dancing shadows that seem to twist and writhe like malevolent spirits.

The door to the cell, rusted and ancient, as if no soul has touched it in centuries.

A small, flickering bonfire sits here, offering a brief respite from the darkness. The flames seem to whisper secrets long forgotten.

You can also see a Corridor Door here.

>south
The Corridor Door slams shut behind you with a heavy thud. It clicks audibly, locking itself.

Asylum Grounds
The grounds stretch out before you, illuminated only by flickering torches. Shadows dance menacingly along the walls. There is a sense of foreboding that makes your skin crawl.

You can see a Corridor Door, a Hallway Door and an Asylum Demon here.

The air grows heavier, and you hear the deep, guttural growl of the Asylum Demon echoing through the walls. You must hurry.

>north
(first opening the Corridor Door)
It seems to be locked.

You hear the thunderous steps of the Asylum Demon drawing closer. You feel its presence looming over you. Time is running out.

>east
As you step through, the Hallway Door creaks ominously before slamming shut, the lock clicking into place.

Lower Asylum Hallway
A gloomy hallway stretches into the shadows, the flickering light barely revealing the cold stone walls.

An old iron door, its surface mottled with rust.

A towering figure in battered armor stands here, leaning heavily on a massive sword. The helmet obscures their face, but their posture suggests exhaustion rather than hostility.

You can also see a Hallway Door here.

>west
(first opening the Hallway Door)
It seems to be locked.

>north
(first opening the Upper Hallway Door)

Upper Asylum Hallway
A chilling silence pervades the air in this narrow, dark hallway. The faint sound of dripping water echoes through the space.

An old iron door, its surface mottled with rust.

A frail figure slumps against the wall, their armor battered and bloodstained. They clutch a deep wound in their side, struggling to breathe. The seem to be holding a strange vial very tightly.

>ask about vial
You can't see any such thing.

>greet him
The soldier's head tilts slightly, their eyes fluttering open. They look at you weakly, a faint glimmer of recognition in their gaze.

>ask about the vial
You can't see any such thing.

>ask him about vial
The soldier coughs weakly, struggling to comprehend your question. "I... I don't know..." they whisper before slumping further.

>ask him vial
The soldier coughs weakly, struggling to comprehend your question. "I... I don't know..." they whisper before slumping further.

>ask him for the vial
The Dying Soldier has better things to do.

>ask him what is the vial
"This vial," the soldier whispers, holding it weakly. "It will sustain you for a time... but use it wisely. Such gifts are rare."

He lessens his grip on the health vial and hands you it shakily.

>go west
Asylum Corridor
You step into a narrow, dimly lit hallway, the air thick with the scent of mildew and decay. The cold, damp stone walls seem to close in around you, their surfaces slick with moisture. Flickering torches cast long, dancing shadows that seem to twist and writhe like malevolent spirits.

The door to the cell, rusted and ancient, as if no soul has touched it in centuries.

A small, flickering bonfire sits here, offering a brief respite from the darkness. The flames seem to whisper secrets long forgotten.

You can also see a Corridor Door here.

>restart
Are you sure you want to restart?

>yes
You have been left in some strange cell.

DS
An Interactive Fiction by Cameron
Release 1 / Serial number 250126 / Inform 7 v10.1.2 / D

Undead Asylum
You find yourself in a dimly lit cell, damp and cold. The air is thick with the smell of moss and decay.

The door to the cell, rusted and ancient, as if no soul has touched it in centuries.

You can also see a rock here.

>unlock cell
What do you want to unlock the cell door with?

* * *

>rock
(first taking the rock)
You use the rock on the cell door. It breaks the rusty lock open with a loud clank. The door slowly creaks open.

>go south
As you step into the corridor, you feel a chill run down your spine. The bonfire's light flickers, casting eerie shadows. In the distance, you hear the sound of heavy footsteps.

(first opening the cell door)

Asylum Corridor
You step into a narrow, dimly lit hallway, the air thick with the scent of mildew and decay. The cold, damp stone walls seem to close in around you, their surfaces slick with moisture. Flickering torches cast long, dancing shadows that seem to twist and writhe like malevolent spirits.

The door to the cell, rusted and ancient, as if no soul has touched it in centuries.

A small, flickering bonfire sits here, offering a brief respite from the darkness. The flames seem to whisper secrets long forgotten.

You can also see a Corridor Door here.

>go south
The Corridor Door slams shut behind you with a heavy thud. It clicks audibly, locking itself.

Asylum Grounds
The grounds stretch out before you, illuminated only by flickering torches. Shadows dance menacingly along the walls. There is a sense of foreboding that makes your skin crawl.

You can see a Corridor Door, a Hallway Door and an Asylum Demon here.

The air grows heavier, and you hear the deep, guttural growl of the Asylum Demon echoing through the walls. You must hurry.

>go north
(first opening the Corridor Door)
It seems to be locked.

You hear the thunderous steps of the Asylum Demon drawing closer. You feel its presence looming over you. Time is running out.

>go east
Lower Asylum Hallway
A gloomy hallway stretches into the shadows, the flickering light barely revealing the cold stone walls.

An old iron door, its surface mottled with rust.

A towering figure in battered armor stands here, leaning heavily on a massive sword. The helmet obscures their face, but their posture suggests exhaustion rather than hostility.

You can also see a Hallway Door here.

* * *

>rock
(first taking the rock)
You use the rock on the cell door. It breaks the rusty lock open with a loud clank. The door slowly creaks open.

>go through cell
(first opening the cell door)

Asylum Corridor
You step into a narrow, dimly lit hallway, the air thick with the scent of mildew and decay. The cold, damp stone walls seem to close in around you, their surfaces slick with moisture. Flickering torches cast long, dancing shadows that seem to twist and writhe like malevolent spirits.

The door to the cell, rusted and ancient, as if no soul has touched it in centuries.

A small, flickering bonfire sits here, offering a brief respite from the darkness. The flames seem to whisper secrets long forgotten.

You can also see a Corridor Door here.

>go through corridor door
(first opening the Corridor Door)

Asylum Grounds
The grounds stretch out before you, illuminated only by flickering torches. Shadows dance menacingly along the walls. There is a sense of foreboding that makes your skin crawl.

You can see a Corridor Door, a Hallway Door and an Asylum Demon here.

The air grows heavier, and you hear the deep, guttural growl of the Asylum Demon echoing through the walls. You must hurry.

>go through corridor door
Asylum Corridor
You step into a narrow, dimly lit hallway, the air thick with the scent of mildew and decay. The cold, damp stone walls seem to close in around you, their surfaces slick with moisture. Flickering torches cast long, dancing shadows that seem to twist and writhe like malevolent spirits.

The door to the cell, rusted and ancient, as if no soul has touched it in centuries.

A small, flickering bonfire sits here, offering a brief respite from the darkness. The flames seem to whisper secrets long forgotten.

You can also see a Corridor Door here.

* * *

>go through corridor door
Asylum Grounds
The grounds stretch out before you, illuminated only by flickering torches. Shadows dance menacingly along the walls. There is a sense of foreboding that makes your skin crawl.

You can see a Corridor Door, a Hallway Door and an Asylum Demon here.

>close corridor door
...but it looks so inviting! Why not just step through it and see what's on the other side?

>go south from asylum corridor
I only understood you as far as wanting to go south.

>go south
You can't go that way.

>go north
Asylum Corridor
You step into a narrow, dimly lit hallway, the air thick with the scent of mildew and decay. The cold, damp stone walls seem to close in around you, their surfaces slick with moisture. Flickering torches cast long, dancing shadows that seem to twist and writhe like malevolent spirits.

The door to the cell, rusted and ancient, as if no soul has touched it in centuries.

A small, flickering bonfire sits here, offering a brief respite from the darkness. The flames seem to whisper secrets long forgotten.

You can also see a Corridor Door here.

>go south
The Corridor Door slams shut behind you with a heavy thud. It clicks audibly, locking itself.

Asylum Grounds
The grounds stretch out before you, illuminated only by flickering torches. Shadows dance menacingly along the walls. There is a sense of foreboding that makes your skin crawl.

You can see a Corridor Door, a Hallway Door and an Asylum Demon here.

* * *

>go through corridor door
Asylum Grounds
The grounds stretch out before you, illuminated only by flickering torches. Shadows dance menacingly along the walls. There is a sense of foreboding that makes your skin crawl.

You can see a Corridor Door, a Hallway Door and an Asylum Demon here.

>go through corridor door
Asylum Corridor
You step into a narrow, dimly lit hallway, the air thick with the scent of mildew and decay. The cold, damp stone walls seem to close in around you, their surfaces slick with moisture. Flickering torches cast long, dancing shadows that seem to twist and writhe like malevolent spirits.

The door to the cell, rusted and ancient, as if no soul has touched it in centuries.

A small, flickering bonfire sits here, offering a brief respite from the darkness. The flames seem to whisper secrets long forgotten.

You can also see a Corridor Door here.

>go south
The Corridor Door slams shut behind you with a heavy thud. It clicks audibly, locking itself.

Asylum Grounds
The grounds stretch out before you, illuminated only by flickering torches. Shadows dance menacingly along the walls. There is a sense of foreboding that makes your skin crawl.

You can see a Corridor Door, a Hallway Door and an Asylum Demon here.

>go north
(first opening the Corridor Door)
It seems to be locked.

>go north
(first opening the Corridor Door)
It seems to be locked.

* * *

>go through corridor door
Asylum Grounds
The grounds stretch out before you, illuminated only by flickering torches. Shadows dance menacingly along the walls. There is a sense of foreboding that makes your skin crawl.

You can see a Corridor Door, a Hallway Door and an Asylum Demon here.

>look
Asylum Grounds
The grounds stretch out before you, illuminated only by flickering torches. Shadows dance menacingly along the walls. There is a sense of foreboding that makes your skin crawl.

You can see a Corridor Door, a Hallway Door and an Asylum Demon here.

You hear the thunderous steps of the Asylum Demon drawing closer. You feel its presence looming over you. Time is running out.

>go through corridor door
Asylum Corridor
You step into a narrow, dimly lit hallway, the air thick with the scent of mildew and decay. The cold, damp stone walls seem to close in around you, their surfaces slick with moisture. Flickering torches cast long, dancing shadows that seem to twist and writhe like malevolent spirits.

The door to the cell, rusted and ancient, as if no soul has touched it in centuries.

A small, flickering bonfire sits here, offering a brief respite from the darkness. The flames seem to whisper secrets long forgotten.

You can also see a Corridor Door here.

* * *

>look at corridor door
The heavy wooden door looms before you, its surface marred by deep claw marks and the stains of time. Rusted iron bands reinforce its frame, and the faint scent of mildew wafts from the cracks. Each creak of its hinges echoes through the air, as though the door itself protests against being opened. It feels as though it has been both a barrier of protection and a harbinger of doom.

>open corridor door
You open the Corridor Door.

>go through corridor door
The sturdy door closes tightly behind you with a slam.

Asylum Grounds
The grounds stretch out before you, illuminated only by flickering torches. Shadows dance menacingly along the walls. There is a sense of foreboding that makes your skin crawl.

A heavy wooden door creaks ominously on its hinges.

You can also see a Corridor Door and an Asylum Demon here.

The air grows heavier, and you hear the deep, guttural growl of the Asylum Demon echoing through the walls. You must hurry.

>look around
You can't see any such thing.

>look
Asylum Grounds
The grounds stretch out before you, illuminated only by flickering torches. Shadows dance menacingly along the walls. There is a sense of foreboding that makes your skin crawl.

A heavy wooden door creaks ominously on its hinges.

You can also see a Corridor Door and an Asylum Demon here.

You hear the thunderous steps of the Asylum Demon drawing closer. You feel its presence looming over you. Time is running out.

>attack demon
You throw the miniscule rock at the demon. The rock crumbles into dust after colliding with its hide. Now what?

The ground shakes violently as the Asylum Demon slams its massive hammer down, crushing you instantly. Darkness consumes you.

    *** You were slain by the Asylum Demon. ***

Would you like to RESTART, RESTORE a saved game, QUIT or UNDO the last command?

* * *

>sit at bonfire
I didn't understand that sentence.

* * *

>sit bonfire
I didn't understand that sentence.

>sit at bonfire
I didn't understand that sentence.

>enter bonfire
You sit by the bonfire. The warmth of the flames washes over you, and a faint sense of relief settles in. The health vial in your possession seems to glow brighter, its contents replenished.
However, without a health vial in your possession, the bonfire's restorative power is of no use.

>exit bonfire
I only understood you as far as wanting to exit.

>look
Asylum Corridor
You step into a narrow, dimly lit hallway, the air thick with the scent of mildew and decay. The cold, damp stone walls seem to close in around you, their surfaces slick with moisture. Flickering torches cast long, dancing shadows that seem to twist and writhe like malevolent spirits.

A sturdy door looms to keep things in. Or out.

The door to the cell, rusted and ancient, as if no soul has touched it in centuries.

A small, flickering bonfire sits here, offering a brief respite from the darkness. The flames seem to whisper secrets long forgotten.

>open door
Which do you mean, the Corridor Door or the cell door?

>corridor
You open the Corridor Door.

>go through corridor door
Asylum Grounds
The grounds stretch out before you, illuminated only by flickering torches. Shadows dance menacingly along the walls. There is a sense of foreboding that makes your skin crawl.

A sturdy door looms to keep things in. Or out.

A heavy wooden door creaks ominously on its hinges.

You can also see an Asylum Demon here.

The air grows heavier, and you hear the deep, guttural growl of the Asylum Demon echoing through the walls. You must hurry.

>go through corridor door
Asylum Corridor
You step into a narrow, dimly lit hallway, the air thick with the scent of mildew and decay. The cold, damp stone walls seem to close in around you, their surfaces slick with moisture. Flickering torches cast long, dancing shadows that seem to twist and writhe like malevolent spirits.

A sturdy door looms to keep things in. Or out.

The door to the cell, rusted and ancient, as if no soul has touched it in centuries.

A small, flickering bonfire sits here, offering a brief respite from the darkness. The flames seem to whisper secrets long forgotten.

>go through corridor door
Asylum Grounds
The grounds stretch out before you, illuminated only by flickering torches. Shadows dance menacingly along the walls. There is a sense of foreboding that makes your skin crawl.

A sturdy door looms to keep things in. Or out.

A heavy wooden door creaks ominously on its hinges.

You can also see an Asylum Demon here.

You hear the thunderous steps of the Asylum Demon drawing closer. You feel its presence looming over you. Time is running out.

>talk to demon
That's not a verb I recognise.

>look
Asylum Grounds
The grounds stretch out before you, illuminated only by flickering torches. Shadows dance menacingly along the walls. There is a sense of foreboding that makes your skin crawl.

A sturdy door looms to keep things in. Or out.

A heavy wooden door creaks ominously on its hinges.

You can also see an Asylum Demon here.

The ground shakes violently as the Asylum Demon slams its massive hammer down, crushing you instantly. Darkness consumes you.

    *** You were slain by the Asylum Demon. ***

Would you like to RESTART, RESTORE a saved game, QUIT or UNDO the last command?

* * *

>east
It seems like the path is too high to get to, but a strange glow is faintly visible.

>south
The Corridor Door slams shut behind you with a heavy thud. It clicks audibly, locking itself.

Asylum Grounds
The grounds stretch out before you, illuminated only by flickering torches. Shadows dance menacingly along the walls. There is a sense of foreboding that makes your skin crawl.

You can see a Corridor Door, a Hallway Door and an Asylum Demon here.

The air grows heavier, and you hear the deep, guttural growl of the Asylum Demon echoing through the walls. You must hurry.

>east
As you step through, the Hallway Door creaks ominously before slamming shut, the lock clicking into place.

Lower Asylum Hallway
A gloomy hallway stretches into the shadows, the flickering light barely revealing the cold stone walls.

An old iron door, its surface mottled with rust.

A towering figure in battered armor stands here, leaning heavily on a massive sword. The helmet obscures their face, but their posture suggests exhaustion rather than hostility.

You can also see a Hallway Door here.

>north
(first opening the Upper Hallway Door)

Upper Asylum Hallway
A chilling silence pervades the air in this narrow, dark hallway. The faint sound of dripping water echoes through the space.

An old iron door, its surface mottled with rust.

A frail figure slumps against the wall, their armor battered and bloodstained. They clutch a deep wound in their side, struggling to breathe. The seem to be holding a strange vial very tightly.

>greet him
The soldier's head tilts slightly, their eyes fluttering open. They look at you weakly, a faint glimmer of recognition in their gaze.

>ask him what is that vial
"This vial," the soldier whispers, holding it weakly. "It will sustain you for a time... but use it wisely. Such gifts are rare."

He lessens his grip on the health vial and hands you it shakily.

>west
Asylum Corridor
You step into a narrow, dimly lit hallway, the air thick with the scent of mildew and decay. The cold, damp stone walls seem to close in around you, their surfaces slick with moisture. Flickering torches cast long, dancing shadows that seem to twist and writhe like malevolent spirits.

The door to the cell, rusted and ancient, as if no soul has touched it in centuries.

A small, flickering bonfire sits here, offering a brief respite from the darkness. The flames seem to whisper secrets long forgotten.

You can also see a Corridor Door here.

>south
The Corridor Door slams shut behind you with a heavy thud. It clicks audibly, locking itself.

Asylum Grounds
The grounds stretch out before you, illuminated only by flickering torches. Shadows dance menacingly along the walls. There is a sense of foreboding that makes your skin crawl.

You can see a Hallway Door, a Corridor Door and an Asylum Demon here.

You hear the thunderous steps of the Asylum Demon drawing closer. You feel its presence looming over you. Time is running out.

* * *

>look
Asylum Corridor
You step into a narrow, dimly lit hallway, the air thick with the scent of mildew and decay. The cold, damp stone walls seem to close in around you, their surfaces slick with moisture. Flickering torches cast long, dancing shadows that seem to twist and writhe like malevolent spirits.

The door to the cell, rusted and ancient, as if no soul has touched it in centuries.

A small, flickering bonfire sits here, offering a brief respite from the darkness. The flames seem to whisper secrets long forgotten.

You can also see a Corridor Door here.

>east
It seems like the path is too high to get to, but a strange glow is faintly visible.

>west
You can't go that way.

>south
The Corridor Door slams shut behind you with a heavy thud. It clicks audibly, locking itself.

Asylum Grounds
The grounds stretch out before you, illuminated only by flickering torches. Shadows dance menacingly along the walls. There is a sense of foreboding that makes your skin crawl.

You can see a Corridor Door, a Hallway Door and an Asylum Demon here.

The air grows heavier, and you hear the deep, guttural growl of the Asylum Demon echoing through the walls. You must hurry.

* * *

>west
(first opening the Hallway Door)
It seems to be locked.

>talk to figure
That's not a verb I recognise.

>ask figure for a weapon
"A weapon of great strength," the knight says, handing you a massive greatsword. "Wield it with care."

>north
(first opening the Upper Hallway Door)

Upper Asylum Hallway
A chilling silence pervades the air in this narrow, dark hallway. The faint sound of dripping water echoes through the space.

An old iron door, its surface mottled with rust.

A frail figure slumps against the wall, their armor battered and bloodstained. They clutch a deep wound in their side, struggling to breathe. The seem to be holding a strange vial very tightly.

>greet figure
You can't see any such thing.

>greet him
The soldier's head tilts slightly, their eyes fluttering open. They look at you weakly, a faint glimmer of recognition in their gaze.

>ask him what is the vial
"This vial," the soldier whispers, holding it weakly. "It will sustain you for a time... but use it wisely. Such gifts are rare."

He lessens his grip on the health vial and hands you it shakily.

* * *

>east
As you step through, the Hallway Door creaks ominously before slamming shut, the lock clicking into place.

Lower Asylum Hallway
A gloomy hallway stretches into the shadows, the flickering light barely revealing the cold stone walls.

An old iron door, its surface mottled with rust.

A towering figure in battered armor stands here, leaning heavily on a massive sword. The helmet obscures their face, but their posture suggests exhaustion rather than hostility.

You can also see a Hallway Door here.

>ask figure weapon
"A weapon of great strength," the knight says, handing you a massive greatsword. "Wield it with care."

>north
(first opening the Upper Hallway Door)

Upper Asylum Hallway
A chilling silence pervades the air in this narrow, dark hallway. The faint sound of dripping water echoes through the space.

An old iron door, its surface mottled with rust.

A frail figure slumps against the wall, their armor battered and bloodstained. They clutch a deep wound in their side, struggling to breathe. The seem to be holding a strange vial very tightly.

>ask figure where am i
You can't see any such thing.

>greet him
The soldier's head tilts slightly, their eyes fluttering open. They look at you weakly, a faint glimmer of recognition in their gaze.

>ask him about himself
The soldier coughs weakly, struggling to comprehend your question. "I... I don't know..." they whisper before slumping further.

>ask him where am i
The soldier coughs weakly, struggling to comprehend your question. "I... I don't know..." they whisper before slumping further.

>ask the soldier where am i
The soldier coughs weakly, struggling to comprehend your question. "I... I don't know..." they whisper before slumping further.

>ask him about the asylum
"The grounds stretch beyond the hallways, twisting into darkness. The demon guards the way... you must be prepared."

>ask him about the vial
The soldier coughs weakly, struggling to comprehend your question. "I... I don't know..." they whisper before slumping further.

>ask him what is that vial
"This vial," the soldier whispers, holding it weakly. "It will sustain you for a time... but use it wisely. Such gifts are rare."

He lessens his grip on the health vial and hands you it shakily.

>ask soldier
What do you want to ask the Dying Soldier for?

>about the vial
"This vial," the soldier whispers, holding it weakly. "It will sustain you for a time... but use it wisely. Such gifts are rare."

He lessens his grip on the health vial and hands you it shakily.

* * *

>north
(first opening the Upper Hallway Door)

Upper Asylum Hallway
A chilling silence pervades the air in this narrow, dark hallway. The faint sound of dripping water echoes through the space.

An old iron door, its surface mottled with rust.

A frail figure slumps against the wall, their armor battered and bloodstained. They clutch a deep wound in their side, struggling to breathe. The seem to be holding a strange vial very tightly.

>west
You should probably find a better weapon before you go back down.

>south
Lower Asylum Hallway
A gloomy hallway stretches into the shadows, the flickering light barely revealing the cold stone walls.

An old iron door, its surface mottled with rust.

A towering figure in battered armor stands here, leaning heavily on a massive sword. The helmet obscures their face, but their posture suggests exhaustion rather than hostility.

You can also see a Hallway Door here.

>ask figure bow
"A ranged weapon for the precise," the knight says, handing you a sturdy bow. "Keep your distance."

>north
Upper Asylum Hallway
A chilling silence pervades the air in this narrow, dark hallway. The faint sound of dripping water echoes through the space.

An old iron door, its surface mottled with rust.

A frail figure slumps against the wall, their armor battered and bloodstained. They clutch a deep wound in their side, struggling to breathe. The seem to be holding a strange vial very tightly.

* * *

>south
Lower Asylum Hallway
A gloomy hallway stretches into the shadows, the flickering light barely revealing the cold stone walls.

An old iron door, its surface mottled with rust.

A towering figure in battered armor stands here, leaning heavily on a massive sword. The helmet obscures their face, but their posture suggests exhaustion rather than hostility.

You can also see a Hallway Door here.

>ask figure dagger
"A swift and silent tool," the knight says, handing you a sharp dagger. "Strike true."

>north
Upper Asylum Hallway
A chilling silence pervades the air in this narrow, dark hallway. The faint sound of dripping water echoes through the space.

An old iron door, its surface mottled with rust.

A frail figure slumps against the wall, their armor battered and bloodstained. They clutch a deep wound in their side, struggling to breathe. The seem to be holding a strange vial very tightly.

>west
Asylum Corridor
You step into a narrow, dimly lit hallway, the air thick with the scent of mildew and decay. The cold, damp stone walls seem to close in around you, their surfaces slick with moisture. Flickering torches cast long, dancing shadows that seem to twist and writhe like malevolent spirits.

The door to the cell, rusted and ancient, as if no soul has touched it in centuries.

A small, flickering bonfire sits here, offering a brief respite from the darkness. The flames seem to whisper secrets long forgotten.

You can also see a Corridor Door here.

* * *

>south
The Corridor Door slams shut behind you with a heavy thud. It clicks audibly, locking itself.

Asylum Grounds
The grounds stretch out before you, illuminated only by flickering torches. Shadows dance menacingly along the walls. There is a sense of foreboding that makes your skin crawl.

You can see a Hallway Door, a Corridor Door and an Asylum Demon here.

You hear the thunderous steps of the Asylum Demon drawing closer. You feel its presence looming over you. Time is running out.

>attack demon
You landed a blow on the demon!

You got injured by the demon! You better not take another hit...

>attack demon
You landed a blow on the demon!

    *** You have slain the demon guarding the exit and can leave the Asylum! ***

Would you like to RESTART, RESTORE a saved game, QUIT or UNDO the last command?

* * *

>west
(first opening the Hallway Door)
It seems to be locked.

>ask figure about weapons
The knight tilts their head slightly, as if trying to comprehend your words. "I do not understand your request," they say finally.

* * *

>north
(first opening the Corridor Door)
It seems to be locked.

You hear the thunderous steps of the Asylum Demon drawing closer. You feel its presence looming over you. Time is running out.

>south
You can't go that way.

You got injured by the demon! You better not take another hit...

>east
As you step through, the Hallway Door creaks ominously before slamming shut, the lock clicking into place.

Lower Asylum Hallway
A gloomy hallway stretches into the shadows, the flickering light barely revealing the cold stone walls.

An old iron door, its surface mottled with rust.

A towering figure in battered armor stands here, leaning heavily on a massive sword. The helmet obscures their face, but their posture suggests exhaustion rather than hostility.

You can also see a Hallway Door here.

* * *

>greet him
The soldier's head tilts slightly, their eyes fluttering open. They look at you weakly, a faint glimmer of recognition in their gaze.

>ask him what is vial
"This vial," the soldier whispers, holding it weakly. "It will sustain you for a time... but use it wisely. Such gifts are rare."

He lessens his grip on the health vial and hands you it shakily.

>west
Asylum Corridor
You step into a narrow, dimly lit hallway, the air thick with the scent of mildew and decay. The cold, damp stone walls seem to close in around you, their surfaces slick with moisture. Flickering torches cast long, dancing shadows that seem to twist and writhe like malevolent spirits.

The door to the cell, rusted and ancient, as if no soul has touched it in centuries.

A small, flickering bonfire sits here, offering a brief respite from the darkness. The flames seem to whisper secrets long forgotten.

You can also see a Corridor Door here.

>enter bonfire
You sit by the bonfire. The warmth of the flames washes over you, and a faint sense of relief settles in.
The health vial in your possession seems to glow brighter, its contents replenished.

>use vial
You drink the glowing red liquid from the health vial. A soothing warmth spreads through your body, and your injuries begin to heal. You feel rejuvenated.

>enter bonfire
You sit by the bonfire. The warmth of the flames washes over you, and a faint sense of relief settles in.
The health vial in your possession seems to glow brighter, its contents replenished.

>south
The Corridor Door slams shut behind you with a heavy thud. It clicks audibly, locking itself.

Asylum Grounds
The grounds stretch out before you, illuminated only by flickering torches. Shadows dance menacingly along the walls. There is a sense of foreboding that makes your skin crawl.

You can see a Hallway Door, a Corridor Door and an Asylum Demon here.

The air grows heavier, and you hear the deep, guttural growl of the Asylum Demon echoing through the walls. You must hurry.

>attack demon
You landed a blow on the demon!
the Asylum Demon whips its tail around and hits you square in the torso!

You hear the thunderous steps of the Asylum Demon drawing closer. You feel its presence looming over you. Time is running out.

* * *

>north
(first opening the Corridor Door)
It seems to be locked.

You hear the thunderous steps of the Asylum Demon drawing closer. You feel its presence looming over you. Time is running out.

>west
You can't go that way.

You got injured by the demon! You better not take another hit...

>east
As you step through, the Hallway Door creaks ominously before slamming shut, the lock clicking into place.

Lower Asylum Hallway
A gloomy hallway stretches into the shadows, the flickering light barely revealing the cold stone walls.

An old iron door, its surface mottled with rust.

A towering figure in battered armor stands here, leaning heavily on a massive sword. The helmet obscures their face, but their posture suggests exhaustion rather than hostility.

You can also see a Hallway Door here.

>ask figure about weapon
"A weapon of great strength," the knight says, handing you a massive greatsword. "Wield it with care."

>north
(first opening the Upper Hallway Door)

Upper Asylum Hallway
A chilling silence pervades the air in this narrow, dark hallway. The faint sound of dripping water echoes through the space.

An old iron door, its surface mottled with rust.

A frail figure slumps against the wall, their armor battered and bloodstained. They clutch a deep wound in their side, struggling to breathe. The seem to be holding a strange vial very tightly.

* * *

>ask him what is vial
"This vial," the soldier whispers, holding it weakly. "It will sustain you for a time... but use it wisely. Such gifts are rare."

He lessens his grip on the health vial and hands you it shakily.

>east
You can't go that way.

>west
Asylum Corridor
You step into a narrow, dimly lit hallway, the air thick with the scent of mildew and decay. The cold, damp stone walls seem to close in around you, their surfaces slick with moisture. Flickering torches cast long, dancing shadows that seem to twist and writhe like malevolent spirits.

The door to the cell, rusted and ancient, as if no soul has touched it in centuries.

A small, flickering bonfire sits here, offering a brief respite from the darkness. The flames seem to whisper secrets long forgotten.

You can also see a Corridor Door here.

>use vial
The health vial is empty. It can only be refilled at a bonfire.

>enter bonfire
You sit by the bonfire. The warmth of the flames washes over you, and a faint sense of relief settles in.
The health vial in your possession seems to glow brighter, its contents replenished.

>south
The Corridor Door slams shut behind you with a heavy thud. It clicks audibly, locking itself.

Asylum Grounds
The grounds stretch out before you, illuminated only by flickering torches. Shadows dance menacingly along the walls. There is a sense of foreboding that makes your skin crawl.

You can see a Hallway Door, a Corridor Door and an Asylum Demon here.

* * *

>west
(first opening the Hallway Door)
It seems to be locked.

>ask figure weapon
"A weapon of great strength," the knight says, handing you a massive greatsword. "Wield it with care."

* * *

>ask him what is the vial
"This vial," the soldier whispers, holding it weakly. "It will sustain you for a time... but use it wisely. Such gifts are rare."

He lessens his grip on the health vial and hands you it shakily.

>east
You can't go that way.

* * *

>enter bonfire
You sit by the bonfire. The warmth of the flames washes over you, and a faint sense of relief settles in.
The health vial in your possession seems to glow brighter, its contents replenished.

>exit bonfire
I only understood you as far as wanting to exit.

>north
Undead Asylum
You find yourself in a dimly lit cell, damp and cold. The air is thick with the smell of moss and decay.

The door to the cell, rusted and ancient, as if no soul has touched it in centuries.

>south
As you step into the corridor, you feel a chill run down your spine. The bonfire's light flickers, casting eerie shadows. In the distance, you hear the sound of heavy footsteps.

Asylum Corridor
You step into a narrow, dimly lit hallway, the air thick with the scent of mildew and decay. The cold, damp stone walls seem to close in around you, their surfaces slick with moisture. Flickering torches cast long, dancing shadows that seem to twist and writhe like malevolent spirits.

The door to the cell, rusted and ancient, as if no soul has touched it in centuries.

A small, flickering bonfire sits here, offering a brief respite from the darkness. The flames seem to whisper secrets long forgotten.

You can also see a Corridor Door here.

>use vial
You drink the glowing red liquid from the health vial. A soothing warmth spreads through your body, and your injuries begin to heal. You feel rejuvenated.

* * *

>south
The Corridor Door slams shut behind you with a heavy thud. It clicks audibly, locking itself.

Asylum Grounds
The grounds stretch out before you, illuminated only by flickering torches. Shadows dance menacingly along the walls. There is a sense of foreboding that makes your skin crawl.

You can see a Hallway Door, a Corridor Door and an Asylum Demon here.

>attack demon
You landed a blow on the demon!

* * *

>west
You can't go that way.

You got injured by the demon! You better not take another hit...

>south
You can't go that way.

The air grows heavier, and you hear the deep, guttural growl of the Asylum Demon echoing through the walls. You must hurry.

>south
You can't go that way.

You hear the thunderous steps of the Asylum Demon drawing closer. You feel its presence looming over you. Time is running out.

>south
You can't go that way.

The ground shakes violently as the Asylum Demon slams its massive hammer down, crushing you instantly. Darkness consumes you.

    *** You were slain by the Asylum Demon. ***

Would you like to RESTART, RESTORE a saved game, QUIT or UNDO the last command?

>restart
You have been left in some strange cell.

DS
An Interactive Fiction by Cameron
Release 1 / Serial number 250126 / Inform 7 v10.1.2 / D

Undead Asylum
You find yourself in a dimly lit cell, damp and cold. The air is thick with the smell of moss and decay.

The door to the cell, rusted and ancient, as if no soul has touched it in centuries.

You can also see a rock here.

>unlock cell
What do you want to unlock the cell door with?

* * *

>north
(first opening the Corridor Door)
It seems to be locked.

You hear the thunderous steps of the Asylum Demon drawing closer. You feel its presence looming over you. Time is running out.

>west
You can't go that way.

The ground shakes violently as the Asylum Demon slams its massive hammer down, crushing you instantly. Darkness consumes you.
You got injured by the demon! You better not take another hit...

>east
As you step through, the Hallway Door creaks ominously before slamming shut, the lock clicking into place.

Lower Asylum Hallway
A gloomy hallway stretches into the shadows, the flickering light barely revealing the cold stone walls.

An old iron door, its surface mottled with rust.

A towering figure in battered armor stands here, leaning heavily on a massive sword. The helmet obscures their face, but their posture suggests exhaustion rather than hostility.

You can also see a Hallway Door here.

* * *

>west
(first opening the Hallway Door)
It seems to be locked.

>ask figure about weapon
"A weapon of great strength," the knight says, handing you a massive greatsword. "Wield it with care."

* * *

>greet him
The soldier's head tilts slightly, their eyes fluttering open. They look at you weakly, a faint glimmer of recognition in their gaze.

>ask about vial
You can't see any such thing.

>ask what is vial
You can't see any such thing.

>ask him what is vial
"This vial," the soldier whispers, holding it weakly. "It will sustain you for a time... but use it wisely. Such gifts are rare."

He lessens his grip on the health vial and hands you it shakily.

>inventory
You are carrying:
  a health vial
  a greatsword
  a rock
  a tattered map
  a broken sword

>west
Asylum Corridor
You step into a narrow, dimly lit hallway, the air thick with the scent of mildew and decay. The cold, damp stone walls seem to close in around you, their surfaces slick with moisture. Flickering torches cast long, dancing shadows that seem to twist and writhe like malevolent spirits.

The door to the cell, rusted and ancient, as if no soul has touched it in centuries.

A small, flickering bonfire sits here, offering a brief respite from the darkness. The flames seem to whisper secrets long forgotten.

You can also see a Corridor Door here.

>south
The Corridor Door slams shut behind you with a heavy thud. It clicks audibly, locking itself.

Asylum Grounds
The grounds stretch out before you, illuminated only by flickering torches. Shadows dance menacingly along the walls. There is a sense of foreboding that makes your skin crawl.

You can see a Hallway Door, a Corridor Door and an Asylum Demon here.

* * *

>attack demon
You landed a blow on the demon!

>look demon
A massive, grotesque demon, its body twisted and malformed. It wields a giant hammer, ready to crush any who dare challenge it.

>use vial
That's not a verb I recognise.

>drink vial
There's nothing suitable to drink here.

>vial
That's not a verb I recognise.

* * *

You have been left in some strange cell.

DS
An Interactive Fiction by Cameron
Release 1 / Serial number 250127 / Inform 7 v10.1.2 / D

Undead Asylum
You find yourself in a dimly lit cell, damp and cold. The air is thick with the smell of moss and decay.

The door to the cell, rusted and ancient, as if no soul has touched it in centuries.

You can also see a rock here.

>unlock cell door
What do you want to unlock the cell door with?

>rock
(first taking the rock)
You use the rock on the cell door. It breaks the rusty lock open with a loud clank. The door slowly creaks open.

>go through
What do you want to go through?

>door
(first opening the cell door)

Asylum Corridor
You step into a narrow, dimly lit hallway, the air thick with the scent of mildew and decay. The cold, damp stone walls seem to close in around you, their surfaces slick with moisture. Flickering torches cast long, dancing shadows that seem to twist and writhe like malevolent spirits.

The door to the cell, rusted and ancient, as if no soul has touched it in centuries.

A small, flickering bonfire sits here, offering a brief respite from the darkness. The flames seem to whisper secrets long forgotten.

You can also see a Corridor Door here.

>go through corridor door
(first opening the Corridor Door)

Asylum Grounds
The grounds stretch out before you, illuminated only by flickering torches. Shadows dance menacingly along the walls. There is a sense of foreboding that makes your skin crawl.

You can see a Corridor Door, a Hallway Door and an Asylum Demon here.

The air grows heavier, and you hear the deep, guttural growl of the Asylum Demon echoing through the walls. You must hurry.

* * *

>rock
(first taking the rock)
You use the rock on the cell door. It breaks the rusty lock open with a loud clank. The door slowly creaks open.

>go through door
(first opening the cell door)

Asylum Corridor
You step into a narrow, dimly lit hallway, the air thick with the scent of mildew and decay. The cold, damp stone walls seem to close in around you, their surfaces slick with moisture. Flickering torches cast long, dancing shadows that seem to twist and writhe like malevolent spirits.

A sturdy door looms to keep things in. Or out.

The door to the cell, rusted and ancient, as if no soul has touched it in centuries.

A small, flickering bonfire sits here, offering a brief respite from the darkness. The flames seem to whisper secrets long forgotten.

>look at corridor door
You see nothing special about the Corridor Door.

* * *

>unlock cell door
What do you want to unlock the cell door with?

>sword
You use the broken sword to pry at the lock. After some effort, the rusty lock gives way, and the door slowly creaks open.

>go through door
(first opening the cell door)

Asylum Corridor
You step into a narrow, dimly lit hallway, the air thick with the scent of mildew and decay. The cold, damp stone walls seem to close in around you, their surfaces slick with moisture. Flickering torches cast long, dancing shadows that seem to twist and writhe like malevolent spirits.

The door to the cell, rusted and ancient, as if no soul has touched it in centuries.

A small, flickering bonfire sits here, offering a brief respite from the darkness. The flames seem to whisper secrets long forgotten.

You can also see a Corridor Door here.

>go through door
Which do you mean, the Corridor Door or the cell door?

>corridor
(first opening the Corridor Door)

Asylum Grounds
The grounds stretch out before you, illuminated only by flickering torches. Shadows dance menacingly along the walls. There is a sense of foreboding that makes your skin crawl.

You can see a Corridor Door, a Hallway Door and an Asylum Demon here.

The air grows heavier, and you hear the deep, guttural growl of the Asylum Demon echoing through the walls. You must hurry.

>attack demon
You swing your broken sword at the demon, but it barely scratches its hide. The demon roars in anger. Maybe you should find another way to survive.

You hear the thunderous steps of the Asylum Demon drawing closer. You feel its presence looming over you. Time is running out.

>examine demon
A massive, grotesque demon, its body twisted and malformed. It wields a giant hammer, ready to crush any who dare challenge it.

The ground shakes violently as the Asylum Demon slams its massive hammer down, crushing you instantly. Darkness consumes you.

    *** You were slain by the Asylum Demon. ***

Would you like to RESTART, RESTORE a saved game, QUIT or UNDO the last command?

* * *

You have been left in some strange cell.

DS
An Interactive Fiction by Cameron
Release 1 / Serial number 250127 / Inform 7 v10.1.2 / D

Undead Asylum
You find yourself in a dimly lit cell, damp and cold. The air is thick with the smell of moss and decay.

The door to the cell, rusted and ancient, as if no soul has touched it in centuries.

You can also see a rock here.

>unlock clel
You can't see any such thing.

>unlock cell
What do you want to unlock the cell door with?

* * *

>greet him
The soldier's head tilts slightly, their eyes fluttering open. They look at you weakly, a faint glimmer of recognition in their gaze.

>ask him vial
The soldier coughs weakly, struggling to comprehend your question. "I... I don't know..." they whisper before slumping further.

>ask him what vial
"This vial," the soldier whispers, holding it weakly. "It will sustain you for a time... but use it wisely. Such gifts are rare."

He lessens his grip on the health vial and hands you it shakily.

>west
Asylum Corridor
You step into a narrow, dimly lit hallway, the air thick with the scent of mildew and decay. The cold, damp stone walls seem to close in around you, their surfaces slick with moisture. Flickering torches cast long, dancing shadows that seem to twist and writhe like malevolent spirits.

The door to the cell, rusted and ancient, as if no soul has touched it in centuries.

A small, flickering bonfire sits here, offering a brief respite from the darkness. The flames seem to whisper secrets long forgotten.

You can also see a Corridor Door here.

* * *

>south
The Corridor Door slams shut behind you with a heavy thud. It clicks audibly, locking itself.

Asylum Grounds
The grounds stretch out before you, illuminated only by flickering torches. Shadows dance menacingly along the walls. There is a sense of foreboding that makes your skin crawl.

You can see a Hallway Door, a Corridor Door and an Asylum Demon here.

The air grows heavier, and you hear the deep, guttural growl of the Asylum Demon echoing through the walls. You must hurry.

>north
(first opening the Corridor Door)
It seems to be locked.

You hear the thunderous steps of the Asylum Demon drawing closer. You feel its presence looming over you. Time is running out.

>attack demon
You landed a blow on the demon!

You got injured by the demon! You better not take another hit...

>north
(first opening the Corridor Door)
It seems to be locked.

The air grows heavier, and you hear the deep, guttural growl of the Asylum Demon echoing through the walls. You must hurry.

>attack demon
You landed a blow on the demon!

    *** You have slain the demon guarding the exit and can leave the Asylum! ***

Would you like to RESTART, RESTORE a saved game, QUIT or UNDO the last command?

* * *

You have been left in some strange cell.

DS
An Interactive Fiction by Cameron
Release 1 / Serial number 250127 / Inform 7 v10.1.2 / D

Undead Asylum
You find yourself in a dimly lit cell, damp and cold. The air is thick with the smell of moss and decay.

The door to the cell, rusted and ancient, as if no soul has touched it in centuries.

You can also see a rock here.

>unlock door
What do you want to unlock the cell door with?

* * *

>go through corridor door
(first opening the Corridor Door)
As you step into the Asylum Grounds, the heavy door slams shut behind you with a resounding thud. The sound reverberates through the air, and you hear the click of a lock. There is no going back.

The air grows heavier, and you hear the deep, guttural growl of the Asylum Demon echoing through the walls. You must hurry.

>attack demon
You throw the miniscule rock at the demon. The rock crumbles into dust after colliding with its hide. Now what?

You hear the thunderous steps of the Asylum Demon drawing closer. You feel its presence looming over you. Time is running out.

>go through corridor door
As you step into the Asylum Grounds, the heavy door slams shut behind you with a resounding thud. The sound reverberates through the air, and you hear the click of a lock. There is no going back.

* * *

>go through corridor door
Asylum Grounds
The grounds stretch out before you, illuminated only by flickering torches. Shadows dance menacingly along the walls. There is a sense of foreboding that makes your skin crawl.

You can see a Corridor Door, a Hallway Door and an Asylum Demon here.

You hear the thunderous steps of the Asylum Demon drawing closer. You feel its presence looming over you. Time is running out.

>attack demon
You throw the miniscule rock at the demon. The rock crumbles into dust after colliding with its hide. Now what?

The ground shakes violently as the Asylum Demon slams its massive hammer down, crushing you instantly. Darkness consumes you.

    *** You were slain by the Asylum Demon. ***

Would you like to RESTART, RESTORE a saved game, QUIT or UNDO the last command?

* * *

>go through corridor door
(first opening the Corridor Door)
As you step into the Asylum Grounds, the heavy door slams shut behind you with a resounding thud. The sound reverberates through the air, and you hear the click of a lock. There is no going back.

The air grows heavier, and you hear the deep, guttural growl of the Asylum Demon echoing through the walls. You must hurry.

>go through hallway door
(first opening the Hallway Door)

Lower Asylum Hallway
A gloomy hallway stretches into the shadows, the flickering light barely revealing the cold stone walls.

An old iron door, its surface mottled with rust.

A towering figure in battered armor stands here, leaning heavily on a massive sword. The helmet obscures their face, but their posture suggests exhaustion rather than hostility.

You can also see a Hallway Door here.

>ask figure about sword
"A weapon of great strength," the knight says, handing you a massive greatsword. "Wield it with care."The knight tilts their head slightly, as if trying to comprehend your words. "I do not understand your request," they say finally.

* * *

>talk to figure
That's not a verb I recognise.

>ask figure weaopn
The knight tilts their head slightly, as if trying to comprehend your words. "I do not understand your request," they say finally.

>ask figure about the sword
"A weapon of great strength," the knight says, handing you a massive greatsword. "Wield it with care."

>inventory
You are carrying:
  a greatsword
  a rock
  a tattered map
  a broken sword

* * *

>go through corridor door
(first opening the Corridor Door)
As you step into the Asylum Grounds, the heavy door slams shut behind you with a resounding thud. The sound reverberates through the air, and you hear the click of a lock. There is no going back.

The air grows heavier, and you hear the deep, guttural growl of the Asylum Demon echoing through the walls. You must hurry.

>look
Asylum Corridor
You step into a narrow, dimly lit hallway, the air thick with the scent of mildew and decay. The cold, damp stone walls seem to close in around you, their surfaces slick with moisture. Flickering torches cast long, dancing shadows that seem to twist and writhe like malevolent spirits.

The door to the cell, rusted and ancient, as if no soul has touched it in centuries.

A small, flickering bonfire sits here, offering a brief respite from the darkness. The flames seem to whisper secrets long forgotten.

You can also see a Corridor Door here.

* * *

>open door
Which do you mean, the Corridor Door or the cell door?

* * *

>corridor
You open the Corridor Door.

>go through corridor door
The sturdy door closes tightly behind you with a slam.

Asylum Grounds
The grounds stretch out before you, illuminated only by flickering torches. Shadows dance menacingly along the walls. There is a sense of foreboding that makes your skin crawl.

You can see a Corridor Door, a Hallway Door and an Asylum Demon here.

The air grows heavier, and you hear the deep, guttural growl of the Asylum Demon echoing through the walls. You must hurry.

>go through the corridor door
The sturdy door closes tightly behind you with a slam.

Asylum Corridor
You step into a narrow, dimly lit hallway, the air thick with the scent of mildew and decay. The cold, damp stone walls seem to close in around you, their surfaces slick with moisture. Flickering torches cast long, dancing shadows that seem to twist and writhe like malevolent spirits.

The door to the cell, rusted and ancient, as if no soul has touched it in centuries.

A small, flickering bonfire sits here, offering a brief respite from the darkness. The flames seem to whisper secrets long forgotten.

You can also see a Corridor Door here.

>go through the corridor door
The sturdy door closes tightly behind you with a slam.

Asylum Grounds
The grounds stretch out before you, illuminated only by flickering torches. Shadows dance menacingly along the walls. There is a sense of foreboding that makes your skin crawl.

You can see a Corridor Door, a Hallway Door and an Asylum Demon here.

You hear the thunderous steps of the Asylum Demon drawing closer. You feel its presence looming over you. Time is running out.

* * *

>south
(first opening the Corridor Door)
As you step into the Asylum Grounds, the heavy door slams shut behind you with a resounding thud. The sound reverberates through the air, and you hear the click of a lock. There is no going back.

The air grows heavier, and you hear the deep, guttural growl of the Asylum Demon echoing through the walls. You must hurry.

>north
You hear the thunderous steps of the Asylum Demon drawing closer. You feel its presence looming over you. Time is running out.

>go through corridor door
Asylum Corridor
You step into a narrow, dimly lit hallway, the air thick with the scent of mildew and decay. The cold, damp stone walls seem to close in around you, their surfaces slick with moisture. Flickering torches cast long, dancing shadows that seem to twist and writhe like malevolent spirits.

The door to the cell, rusted and ancient, as if no soul has touched it in centuries.

A small, flickering bonfire sits here, offering a brief respite from the darkness. The flames seem to whisper secrets long forgotten.

You can also see a Corridor Door here.

* * *

>unlock door
What do you want to unlock the cell door with?

>sword
You use the broken sword to pry at the lock. After some effort, the rusty lock gives way, and the door slowly creaks open.

>go hallway
You can't see any such thing.

>go through
What do you want to go through?

>door
(first opening the cell door)

Asylum Corridor
You step into a narrow, dimly lit hallway, the air thick with the scent of mildew and decay. The cold, damp stone walls seem to close in around you, their surfaces slick with moisture. Flickering torches cast long, dancing shadows that seem to twist and writhe like malevolent spirits.

A sturdy door looms to keep things in. Or out.

The door to the cell, rusted and ancient, as if no soul has touched it in centuries.

A small, flickering bonfire sits here, offering a brief respite from the darkness. The flames seem to whisper secrets long forgotten.

>go through door
Which do you mean, the Corridor Door or the cell door?

* * *

>corridor
(first opening the Corridor Door)

Asylum Grounds
The grounds stretch out before you, illuminated only by flickering torches. Shadows dance menacingly along the walls. There is a sense of foreboding that makes your skin crawl.

A sturdy door looms to keep things in. Or out.

A heavy wooden door creaks ominously on its hinges.

You can also see an Asylum Demon here.

>go through hallway door
(first opening the Hallway Door)

Lower Asylum Hallway
A gloomy hallway stretches into the shadows, the flickering light barely revealing the cold stone walls.

A heavy wooden door creaks ominously on its hinges.

An old iron door, its surface mottled with rust.

>go through iron door
You can't see any such thing.

>go through door
Which do you mean, the Hallway Door or the Upper Hallway Door?

>upper hallway
(first opening the Upper Hallway Door)

Upper Asylum Hallway
A chilling silence pervades the air in this narrow, dark hallway. The faint sound of dripping water echoes through the space.

An old iron door, its surface mottled with rust.

A frail figure slumps against the wall, their armor battered and bloodstained. They clutch a deep wound in their side, struggling to breathe.

>ask dying soldier what is this asylum
"This place... was once a haven for the lost," the soldier murmurs, "but now it's a tomb for the forsaken. Beware what lies in the shadows."

* * *

>go through door
Which do you mean, the Hallway Door or the Upper Hallway Door?

>upper
(first opening the Upper Hallway Door)

Upper Asylum Hallway
A chilling silence pervades the air in this narrow, dark hallway. The faint sound of dripping water echoes through the space.

An old iron door, its surface mottled with rust.

A frail figure slumps against the wall, their armor battered and bloodstained. They clutch a deep wound in their side, struggling to breathe.

>ask dying soldier what is the aslyum
The soldier doesn't seem to hear you. Perhaps you should try to get their attention first.

>say hi to soldier
The soldier doesn't seem to hear you. Perhaps you should try to get their attention first.

>greet soldier
The soldier's head tilts slightly, their eyes fluttering open. They look at you weakly, a faint glimmer of recognition in their gaze.

>ask soldier what is health
"This vial," the soldier whispers, holding it weakly. "It will sustain you for a time... but use it wisely. Such gifts are rare."

* * *

>open door
Which do you mean, the Corridor Door or the cell door?

* * *

>corridor
You open the Corridor Door.

>go through door
Which do you mean, the Corridor Door or the cell door?

>corridor
Asylum Grounds
The grounds stretch out before you, illuminated only by flickering torches. Shadows dance menacingly along the walls. There is a sense of foreboding that makes your skin crawl.

A sturdy door looms to keep things in. Or out.

A heavy wooden door creaks ominously on its hinges.

You can also see an Asylum Demon here.

>go through door
Which do you mean, the Corridor Door or the Hallway Door?

>hallway door
(first opening the Hallway Door)

Lower Asylum Hallway
A gloomy hallway stretches into the shadows, the flickering light barely revealing the cold stone walls.

A heavy wooden door creaks ominously on its hinges.

An old iron door, its surface mottled with rust.

>go through door
Which do you mean, the Hallway Door or the Upper Hallway Door?

>upper hallway door
(first opening the Upper Hallway Door)

Upper Asylum Hallway
A chilling silence pervades the air in this narrow, dark hallway. The faint sound of dripping water echoes through the space.

An old iron door, its surface mottled with rust.

A frail figure slumps against the wall, their armor battered and bloodstained. They clutch a deep wound in their side, struggling to breathe.

* * *

You have been left in some strange cell.

DS
An Interactive Fiction by Cameron
Release 1 / Serial number 250127 / Inform 7 v10.1.2 / D

Undead Asylum
You find yourself in a dimly lit cell, damp and cold. The air is thick with the smell of moss and decay.

The door to the cell, rusted and ancient, as if no soul has touched it in centuries.

You can also see a rock here.

>unlock the cell door
What do you want to unlock the cell door with?

>rock
(first taking the rock)
You use the rock on the cell door. It breaks the rusty lock open with a loud clank. The door slowly creaks open.